/hi bi ˈkɹækɪŋ/	/hiːz ˈjuːʒəli ˈkɹækɪŋ/
/ʃi bi ˈkɹækɪŋ/	/ʃiːz ˈjuːʒəli ˈkɹækɪŋ/
/ðeɪ bi ˈkɹækɪŋ/	/ðeɪ ˈjuːʒəli ˈkɹækɪŋ/
/hi bi ˈlʌvɪŋ/	/hiːz ˈjuːʒəli ˈlʌvɪŋ/
/ʃi bi ˈlʌvɪŋ/	/ʃiːz ˈjuːʒəli ˈlʌvɪŋ/
/ðeɪ bi ˈlʌvɪŋ/	/ðeɪ ˈjuːʒəli ˈlʌvɪŋ/
/hi bi ˈæktɪŋ/	/hiːz ˈjuːʒəli ˈæktɪŋ/
/ʃi bi ˈæktɪŋ/	/ʃiːz ˈjuːʒəli ˈæktɪŋ/
/ðeɪ bi ˈæktɪŋ/	/ðeɪ ˈjuːʒəli ˈæktɪŋ/
/hi bi ˈbloʊɪŋ/	/hiːz ˈjuːʒəli ˈbloʊɪŋ/
/ʃi bi ˈbloʊɪŋ/	/ʃiːz ˈjuːʒəli ˈbloʊɪŋ/
/ðeɪ bi ˈbloʊɪŋ/	/ðeɪ ˈjuːʒəli ˈbloʊɪŋ/
/hi bi ˈpleɪɪŋ/	/hiːz ˈjuːʒəli ˈpleɪɪŋ/
/ʃi bi ˈpleɪɪŋ/	/ʃiːz ˈjuːʒəli ˈpleɪɪŋ/
/ðeɪ bi ˈpleɪɪŋ/	/ðeɪ ˈjuːʒəli ˈpleɪɪŋ/
/hi bi ˈbɔːlɪŋ/	/hiːz ˈjuːʒəli ˈbɔːlɪŋ/
/ʃi bi ˈbɔːlɪŋ/	/ʃiːz ˈjuːʒəli ˈbɔːlɪŋ/
/ðeɪ bi ˈbɔːlɪŋ/	/ðeɪ ˈjuːʒəli ˈbɔːlɪŋ/
/hi bi ˈlɪŋkɪŋ/	/hiːz ˈjuːʒəli ˈlɪŋkɪŋ/
/ʃi bi ˈlɪŋkɪŋ/	/ʃiːz ˈjuːʒəli ˈlɪŋkɪŋ/
/ðeɪ bi ˈlɪŋkɪŋ/	/ðeɪ ˈjuːʒəli ˈlɪŋkɪŋ/
/hi bi ˈheɪtɪŋ/	/hiːz ˈjuːʒəli ˈheɪtɪŋ/
/ʃi bi ˈheɪtɪŋ/	/ʃiːz ˈjuːʒəli ˈheɪtɪŋ/
/ðeɪ bi ˈheɪtɪŋ/	/ðeɪ ˈjuːʒəli ˈheɪtɪŋ/
/hi bi ˈbʌstɪŋ/	/hiːz ˈjuːʒəli ˈbʌstɪŋ/
/ʃi bi ˈbʌstɪŋ/	/ʃiːz ˈjuːʒəli ˈbʌstɪŋ/
/ðeɪ bi ˈbʌstɪŋ/	/ðeɪ ˈjuːʒəli ˈbʌstɪŋ/
/hi bi ˈbʌɡɪŋ/	/hiːz ˈjuːʒəli ˈbʌɡɪŋ/
/ʃi bi ˈbʌɡɪŋ/	/ʃiːz ˈjuːʒəli ˈbʌɡɪŋ/
/ðeɪ bi ˈbʌɡɪŋ/	/ðeɪ ˈjuːʒəli ˈbʌɡɪŋ/
/hi bi ˈfuːlɪŋ/	/hiːz ˈjuːʒəli ˈfuːlɪŋ/
/ʃi bi ˈfuːlɪŋ/	/ʃiːz ˈjuːʒəli ˈfuːlɪŋ/
/ðeɪ bi ˈfuːlɪŋ/	/ðeɪ ˈjuːʒəli ˈfuːlɪŋ/
/hi bi ˈvaɪbɪŋ/	/hiːz ˈjuːʒəli ˈvaɪbɪŋ/
/ʃi bi ˈvaɪbɪŋ/	/ʃiːz ˈjuːʒəli ˈvaɪbɪŋ/
/ðeɪ bi ˈvaɪbɪŋ/	/ðeɪ ˈjuːʒəli ˈvaɪbɪŋ/
/hi bi ˈɹæpɪŋ/	/hiːz ˈjuːʒəli ˈɹæpɪŋ/
/ʃi bi ˈɹæpɪŋ/	/ʃiːz ˈjuːʒəli ˈɹæpɪŋ/
/ðeɪ bi ˈɹæpɪŋ/	/ðeɪ ˈjuːʒəli ˈɹæpɪŋ/
/hi bi ˈblæstɪŋ/	/hiːz ˈjuːʒəli ˈblæstɪŋ/
/ʃi bi ˈblæstɪŋ/	/ʃiːz ˈjuːʒəli ˈblæstɪŋ/
/ðeɪ bi ˈblæstɪŋ/	/ðeɪ ˈjuːʒəli ˈblæstɪŋ/
/hi bi ˈsleɪɪŋ/	/hiːz ˈjuːʒəli ˈsleɪɪŋ/
/ʃi bi ˈsleɪɪŋ/	/ʃiːz ˈjuːʒəli ˈsleɪɪŋ/
/ðeɪ bi ˈsleɪɪŋ/	/ðeɪ ˈjuːʒəli ˈsleɪɪŋ/
/hi bi ˈwɪpɪŋ/	/hiːz ˈjuːʒəli ˈwɪpɪŋ/
/ʃi bi ˈwɪpɪŋ/	/ʃiːz ˈjuːʒəli ˈwɪpɪŋ/
/ðeɪ bi ˈwɪpɪŋ/	/ðeɪ ˈjuːʒəli ˈwɪpɪŋ/
/hi bi ˈfaɪndɪŋ/	/hiːz ˈjuːʒəli ˈfaɪndɪŋ/
/ʃi bi ˈfaɪndɪŋ/	/ʃiːz ˈjuːʒəli ˈfaɪndɪŋ/
/ðeɪ bi ˈfaɪndɪŋ/	/ðeɪ ˈjuːʒəli ˈfaɪndɪŋ/
/hi bi ˈpɑːkɪŋ/	/hiːz ˈjuːʒəli ˈpɑːkɪŋ/
/ʃi bi ˈpɑːkɪŋ/	/ʃiːz ˈjuːʒəli ˈpɑːkɪŋ/
/ðeɪ bi ˈpɑːkɪŋ/	/ðeɪ ˈjuːʒəli ˈpɑːkɪŋ/
/hi bi ˈkɹipɪŋ/	/hiːz ˈjuːʒəli ˈkɹipɪŋ/
/ʃi bi ˈkɹipɪŋ/	/ʃiːz ˈjuːʒəli ˈkɹipɪŋ/
/ðeɪ bi ˈkɹipɪŋ/	/ðeɪ ˈjuːʒəli ˈkɹipɪŋ/
/hi bi ˈfɹɪkɪŋ/	/hiːz ˈjuːʒəli ˈfɹɪkɪŋ/
/ʃi bi ˈfɹɪkɪŋ/	/ʃiːz ˈjuːʒəli ˈfɹɪkɪŋ/
/ðeɪ bi ˈfɹɪkɪŋ/	/ðeɪ ˈjuːʒəli ˈfɹɪkɪŋ/
/hi bi ˈdɹɪpɪŋ/	/hiːz ˈjuːʒəli ˈdɹɪpɪŋ/
/ʃi bi ˈdɹɪpɪŋ/	/ʃiːz ˈjuːʒəli ˈdɹɪpɪŋ/
/ðeɪ bi ˈdɹɪpɪŋ/	/ðeɪ ˈjuːʒəli ˈdɹɪpɪŋ/
/hi bi ˈstɪtʃɪŋ/	/hiːz ˈjuːʒəli ˈstɪtʃɪŋ/
/ʃi bi ˈstɪtʃɪŋ/	/ʃiːz ˈjuːʒəli ˈstɪtʃɪŋ/
/ðeɪ bi ˈstɪtʃɪŋ/	/ðeɪ ˈjuːʒəli ˈstɪtʃɪŋ/
/hi bi ˈkɪlɪŋ/	/hiːz ˈjuːʒəli ˈkɪlɪŋ/
/ʃi bi ˈkɪlɪŋ/	/ʃiːz ˈjuːʒəli ˈkɪlɪŋ/
/ðeɪ bi ˈkɪlɪŋ/	/ðeɪ ˈjuːʒəli ˈkɪlɪŋ/
/hi bi bɪˈliːvɪŋ/	/hiːz ˈjuːʒəli bɪˈliːvɪŋ/
/ʃi bi bɪˈliːvɪŋ/	/ʃiːz ˈjuːʒəli bɪˈliːvɪŋ/
/ðeɪ bi bɪˈliːvɪŋ/	/ðeɪ ˈjuːʒəli bɪˈliːvɪŋ/
/hi bi ˈkʌtɪŋ/	/hiːz ˈjuːʒəli ˈkʌtɪŋ/
/ʃi bi ˈkʌtɪŋ/	/ʃiːz ˈjuːʒəli ˈkʌtɪŋ/
/ðeɪ bi ˈkʌtɪŋ/	/ðeɪ ˈjuːʒəli ˈkʌtɪŋ/
/hi bi ˈɡɛtɪŋ/	/hiːz ˈjuːʒəli ˈɡɛtɪŋ/
/ʃi bi ˈɡɛtɪŋ/	/ʃiːz ˈjuːʒəli ˈɡɛtɪŋ/
/ðeɪ bi ˈɡɛtɪŋ/	/ðeɪ ˈjuːʒəli ˈɡɛtɪŋ/
/hi bi ˈɹaɪdɪŋ/	/hiːz ˈjuːʒəli ˈɹaɪdɪŋ/
/ʃi bi ˈɹaɪdɪŋ/	/ʃiːz ˈjuːʒəli ˈɹaɪdɪŋ/
/ðeɪ bi ˈɹaɪdɪŋ/	/ðeɪ ˈjuːʒəli ˈɹaɪdɪŋ/
/hi bi ˈwɔːkɪŋ/	/hiːz ˈjuːʒəli ˈwɔːkɪŋ/
/ʃi bi ˈwɔːkɪŋ/	/ʃiːz ˈjuːʒəli ˈwɔːkɪŋ/
/ðeɪ bi ˈwɔːkɪŋ/	/ðeɪ ˈjuːʒəli ˈwɔːkɪŋ/
/hi bi ˈbɪtʃɪŋ/	/hiːz ˈjuːʒəli ˈbɪtʃɪŋ/
/ʃi bi ˈbɪtʃɪŋ/	/ʃiːz ˈjuːʒəli ˈbɪtʃɪŋ/
/ðeɪ bi ˈbɪtʃɪŋ/	/ðeɪ ˈjuːʒəli ˈbɪtʃɪŋ/
/hi bi ˈɛvɹɪθɪŋ/	/hiːz ˈjuːʒəli ˈɛvɹɪθɪŋ/
/ʃi bi ˈɛvɹɪθɪŋ/	/ʃiːz ˈjuːʒəli ˈɛvɹɪθɪŋ/
/ðeɪ bi ˈɛvɹɪθɪŋ/	/ðeɪ ˈjuːʒəli ˈɛvɹɪθɪŋ/
/hi bi ˈkɪkɪŋ/	/hiːz ˈjuːʒəli ˈkɪkɪŋ/
/ʃi bi ˈkɪkɪŋ/	/ʃiːz ˈjuːʒəli ˈkɪkɪŋ/
/ðeɪ bi ˈkɪkɪŋ/	/ðeɪ ˈjuːʒəli ˈkɪkɪŋ/
/hi bi ˈkɪdɪŋ/	/hiːz ˈjuːʒəli ˈkɪdɪŋ/
/ʃi bi ˈkɪdɪŋ/	/ʃiːz ˈjuːʒəli ˈkɪdɪŋ/
/ðeɪ bi ˈkɪdɪŋ/	/ðeɪ ˈjuːʒəli ˈkɪdɪŋ/
/hi bi ˈbæŋɪŋ/	/hiːz ˈjuːʒəli ˈbæŋɪŋ/
/ʃi bi ˈbæŋɪŋ/	/ʃiːz ˈjuːʒəli ˈbæŋɪŋ/
/ðeɪ bi ˈbæŋɪŋ/	/ðeɪ ˈjuːʒəli ˈbæŋɪŋ/
/hi bi ˈbɹeɪkɪŋ/	/hiːz ˈjuːʒəli ˈbɹeɪkɪŋ/
/ʃi bi ˈbɹeɪkɪŋ/	/ʃiːz ˈjuːʒəli ˈbɹeɪkɪŋ/
/ðeɪ bi ˈbɹeɪkɪŋ/	/ðeɪ ˈjuːʒəli ˈbɹeɪkɪŋ/
/hi bi ˈtʃætɪŋ/	/hiːz ˈjuːʒəli ˈtʃætɪŋ/
/ʃi bi ˈtʃætɪŋ/	/ʃiːz ˈjuːʒəli ˈtʃætɪŋ/
/ðeɪ bi ˈtʃætɪŋ/	/ðeɪ ˈjuːʒəli ˈtʃætɪŋ/
/hi bi ˈeɪmɪŋ/	/hiːz ˈjuːʒəli ˈeɪmɪŋ/
/ʃi bi ˈeɪmɪŋ/	/ʃiːz ˈjuːʒəli ˈeɪmɪŋ/
/ðeɪ bi ˈeɪmɪŋ/	/ðeɪ ˈjuːʒəli ˈeɪmɪŋ/
/hi bi ˈhɛkɪŋ/	/hiːz ˈjuːʒəli ˈhɛkɪŋ/
/ʃi bi ˈhɛkɪŋ/	/ʃiːz ˈjuːʒəli ˈhɛkɪŋ/
/ðeɪ bi ˈhɛkɪŋ/	/ðeɪ ˈjuːʒəli ˈhɛkɪŋ/
/hi bi ˈstɑːtɪŋ/	/hiːz ˈjuːʒəli ˈstɑːtɪŋ/
/ʃi bi ˈstɑːtɪŋ/	/ʃiːz ˈjuːʒəli ˈstɑːtɪŋ/
/ðeɪ bi ˈstɑːtɪŋ/	/ðeɪ ˈjuːʒəli ˈstɑːtɪŋ/
/hi bi ˈtʃiːzɪŋ/	/hiːz ˈjuːʒəli ˈtʃiːzɪŋ/
/ʃi bi ˈtʃiːzɪŋ/	/ʃiːz ˈjuːʒəli ˈtʃiːzɪŋ/
/ðeɪ bi ˈtʃiːzɪŋ/	/ðeɪ ˈjuːʒəli ˈtʃiːzɪŋ/
/hi bi ˈdɹiːmɪŋ/	/hiːz ˈjuːʒəli ˈdɹiːmɪŋ/
/ʃi bi ˈdɹiːmɪŋ/	/ʃiːz ˈjuːʒəli ˈdɹiːmɪŋ/
/ðeɪ bi ˈdɹiːmɪŋ/	/ðeɪ ˈjuːʒəli ˈdɹiːmɪŋ/
/hi bi ˈfɹʌntɪŋ/	/hiːz ˈjuːʒəli ˈfɹʌntɪŋ/
/ʃi bi ˈfɹʌntɪŋ/	/ʃiːz ˈjuːʒəli ˈfɹʌntɪŋ/
/ðeɪ bi ˈfɹʌntɪŋ/	/ðeɪ ˈjuːʒəli ˈfɹʌntɪŋ/
/hi bi ˈdɹɪŋkɪŋ/	/hiːz ˈjuːʒəli ˈdɹɪŋkɪŋ/
/ʃi bi ˈdɹɪŋkɪŋ/	/ʃiːz ˈjuːʒəli ˈdɹɪŋkɪŋ/
/ðeɪ bi ˈdɹɪŋkɪŋ/	/ðeɪ ˈjuːʒəli ˈdɹɪŋkɪŋ/
/hi bi ˈdɑːlɪŋ/	/hiːz ˈjuːʒəli ˈdɑːlɪŋ/
/ʃi bi ˈdɑːlɪŋ/	/ʃiːz ˈjuːʒəli ˈdɑːlɪŋ/
/ðeɪ bi ˈdɑːlɪŋ/	/ðeɪ ˈjuːʒəli ˈdɑːlɪŋ/
/hi bi ˈpʊlɪŋ/	/hiːz ˈjuːʒəli ˈpʊlɪŋ/
/ʃi bi ˈpʊlɪŋ/	/ʃiːz ˈjuːʒəli ˈpʊlɪŋ/
/ðeɪ bi ˈpʊlɪŋ/	/ðeɪ ˈjuːʒəli ˈpʊlɪŋ/
/hi bi ˈtɔːkɪŋ/	/hiːz ˈjuːʒəli ˈtɔːkɪŋ/
/ʃi bi ˈtɔːkɪŋ/	/ʃiːz ˈjuːʒəli ˈtɔːkɪŋ/
/ðeɪ bi ˈtɔːkɪŋ/	/ðeɪ ˈjuːʒəli ˈtɔːkɪŋ/
/hi bi ˈhæŋɪŋ/	/hiːz ˈjuːʒəli ˈhæŋɪŋ/
/ʃi bi ˈhæŋɪŋ/	/ʃiːz ˈjuːʒəli ˈhæŋɪŋ/
/ðeɪ bi ˈhæŋɪŋ/	/ðeɪ ˈjuːʒəli ˈhæŋɪŋ/
