hi bi ˈkɹækɪn	hiːz ˈjuːʒəli ˈkɹækɪn
ʃi bi ˈkɹækɪn	ʃiːz ˈjuːʒəli ˈkɹækɪn
ðeɪ bi ˈkɹækɪn	ðeɪ ˈjuːʒəli ˈkɹækɪn
hi bi ˈlʌvɪn	hiːz ˈjuːʒəli ˈlʌvɪn
ʃi bi ˈlʌvɪn	ʃiːz ˈjuːʒəli ˈlʌvɪn
ðeɪ bi ˈlʌvɪn	ðeɪ ˈjuːʒəli ˈlʌvɪn
hi bi ˈæktɪn	hiːz ˈjuːʒəli ˈæktɪn
ʃi bi ˈæktɪn	ʃiːz ˈjuːʒəli ˈæktɪn
ðeɪ bi ˈæktɪn	ðeɪ ˈjuːʒəli ˈæktɪn
hi bi ˈbloʊɪn	hiːz ˈjuːʒəli ˈbloʊɪn
ʃi bi ˈbloʊɪn	ʃiːz ˈjuːʒəli ˈbloʊɪn
ðeɪ bi ˈbloʊɪn	ðeɪ ˈjuːʒəli ˈbloʊɪn
hi bi ˈpleɪɪn	hiːz ˈjuːʒəli ˈpleɪɪn
ʃi bi ˈpleɪɪn	ʃiːz ˈjuːʒəli ˈpleɪɪn
ðeɪ bi ˈpleɪɪn	ðeɪ ˈjuːʒəli ˈpleɪɪn
hi bi ˈbɔːlɪn	hiːz ˈjuːʒəli ˈbɔːlɪn
ʃi bi ˈbɔːlɪn	ʃiːz ˈjuːʒəli ˈbɔːlɪn
ðeɪ bi ˈbɔːlɪn	ðeɪ ˈjuːʒəli ˈbɔːlɪn
hi bi ˈlɪnkɪn	hiːz ˈjuːʒəli ˈlɪnkɪn
ʃi bi ˈlɪnkɪn	ʃiːz ˈjuːʒəli ˈlɪnkɪn
ðeɪ bi ˈlɪnkɪn	ðeɪ ˈjuːʒəli ˈlɪnkɪn
hi bi ˈheɪtɪn	hiːz ˈjuːʒəli ˈheɪtɪn
ʃi bi ˈheɪtɪn	ʃiːz ˈjuːʒəli ˈheɪtɪn
ðeɪ bi ˈheɪtɪn	ðeɪ ˈjuːʒəli ˈheɪtɪn
hi bi ˈbʌstɪn	hiːz ˈjuːʒəli ˈbʌstɪn
ʃi bi ˈbʌstɪn	ʃiːz ˈjuːʒəli ˈbʌstɪn
ðeɪ bi ˈbʌstɪn	ðeɪ ˈjuːʒəli ˈbʌstɪn
hi bi ˈbʌɡɪn	hiːz ˈjuːʒəli ˈbʌɡɪn
ʃi bi ˈbʌɡɪn	ʃiːz ˈjuːʒəli ˈbʌɡɪn
ðeɪ bi ˈbʌɡɪn	ðeɪ ˈjuːʒəli ˈbʌɡɪn
hi bi ˈfuːlɪn	hiːz ˈjuːʒəli ˈfuːlɪn
ʃi bi ˈfuːlɪn	ʃiːz ˈjuːʒəli ˈfuːlɪn
ðeɪ bi ˈfuːlɪn	ðeɪ ˈjuːʒəli ˈfuːlɪn
hi bi ˈvaɪbɪn	hiːz ˈjuːʒəli ˈvaɪbɪn
ʃi bi ˈvaɪbɪn	ʃiːz ˈjuːʒəli ˈvaɪbɪn
ðeɪ bi ˈvaɪbɪn	ðeɪ ˈjuːʒəli ˈvaɪbɪn
hi bi ˈɹæpɪn	hiːz ˈjuːʒəli ˈɹæpɪn
ʃi bi ˈɹæpɪn	ʃiːz ˈjuːʒəli ˈɹæpɪn
ðeɪ bi ˈɹæpɪn	ðeɪ ˈjuːʒəli ˈɹæpɪn
hi bi ˈblæstɪn	hiːz ˈjuːʒəli ˈblæstɪn
ʃi bi ˈblæstɪn	ʃiːz ˈjuːʒəli ˈblæstɪn
ðeɪ bi ˈblæstɪn	ðeɪ ˈjuːʒəli ˈblæstɪn
hi bi ˈsleɪɪn	hiːz ˈjuːʒəli ˈsleɪɪn
ʃi bi ˈsleɪɪn	ʃiːz ˈjuːʒəli ˈsleɪɪn
ðeɪ bi ˈsleɪɪn	ðeɪ ˈjuːʒəli ˈsleɪɪn
hi bi ˈwɪpɪn	hiːz ˈjuːʒəli ˈwɪpɪn
ʃi bi ˈwɪpɪn	ʃiːz ˈjuːʒəli ˈwɪpɪn
ðeɪ bi ˈwɪpɪn	ðeɪ ˈjuːʒəli ˈwɪpɪn
hi bi ˈfaɪndɪn	hiːz ˈjuːʒəli ˈfaɪndɪn
ʃi bi ˈfaɪndɪn	ʃiːz ˈjuːʒəli ˈfaɪndɪn
ðeɪ bi ˈfaɪndɪn	ðeɪ ˈjuːʒəli ˈfaɪndɪn
hi bi ˈpɑːkɪn	hiːz ˈjuːʒəli ˈpɑːkɪn
ʃi bi ˈpɑːkɪn	ʃiːz ˈjuːʒəli ˈpɑːkɪn
ðeɪ bi ˈpɑːkɪn	ðeɪ ˈjuːʒəli ˈpɑːkɪn
hi bi ˈkɹipɪn	hiːz ˈjuːʒəli ˈkɹipɪn
ʃi bi ˈkɹipɪn	ʃiːz ˈjuːʒəli ˈkɹipɪn
ðeɪ bi ˈkɹipɪn	ðeɪ ˈjuːʒəli ˈkɹipɪn
hi bi ˈfɹɪkɪn	hiːz ˈjuːʒəli ˈfɹɪkɪn
ʃi bi ˈfɹɪkɪn	ʃiːz ˈjuːʒəli ˈfɹɪkɪn
ðeɪ bi ˈfɹɪkɪn	ðeɪ ˈjuːʒəli ˈfɹɪkɪn
hi bi ˈdɹɪpɪn	hiːz ˈjuːʒəli ˈdɹɪpɪn
ʃi bi ˈdɹɪpɪn	ʃiːz ˈjuːʒəli ˈdɹɪpɪn
ðeɪ bi ˈdɹɪpɪn	ðeɪ ˈjuːʒəli ˈdɹɪpɪn
hi bi ˈstɪtʃɪn	hiːz ˈjuːʒəli ˈstɪtʃɪn
ʃi bi ˈstɪtʃɪn	ʃiːz ˈjuːʒəli ˈstɪtʃɪn
ðeɪ bi ˈstɪtʃɪn	ðeɪ ˈjuːʒəli ˈstɪtʃɪn
hi bi ˈkɪlɪn	hiːz ˈjuːʒəli ˈkɪlɪn
ʃi bi ˈkɪlɪn	ʃiːz ˈjuːʒəli ˈkɪlɪn
ðeɪ bi ˈkɪlɪn	ðeɪ ˈjuːʒəli ˈkɪlɪn
hi bi bɪˈliːvɪn	hiːz ˈjuːʒəli bɪˈliːvɪn
ʃi bi bɪˈliːvɪn	ʃiːz ˈjuːʒəli bɪˈliːvɪn
ðeɪ bi bɪˈliːvɪn	ðeɪ ˈjuːʒəli bɪˈliːvɪn
hi bi ˈkʌtɪn	hiːz ˈjuːʒəli ˈkʌtɪn
ʃi bi ˈkʌtɪn	ʃiːz ˈjuːʒəli ˈkʌtɪn
ðeɪ bi ˈkʌtɪn	ðeɪ ˈjuːʒəli ˈkʌtɪn
hi bi ˈɡɛtɪn	hiːz ˈjuːʒəli ˈɡɛtɪn
ʃi bi ˈɡɛtɪn	ʃiːz ˈjuːʒəli ˈɡɛtɪn
ðeɪ bi ˈɡɛtɪn	ðeɪ ˈjuːʒəli ˈɡɛtɪn
hi bi ˈɹaɪdɪn	hiːz ˈjuːʒəli ˈɹaɪdɪn
ʃi bi ˈɹaɪdɪn	ʃiːz ˈjuːʒəli ˈɹaɪdɪn
ðeɪ bi ˈɹaɪdɪn	ðeɪ ˈjuːʒəli ˈɹaɪdɪn
hi bi ˈwɔːkɪn	hiːz ˈjuːʒəli ˈwɔːkɪn
ʃi bi ˈwɔːkɪn	ʃiːz ˈjuːʒəli ˈwɔːkɪn
ðeɪ bi ˈwɔːkɪn	ðeɪ ˈjuːʒəli ˈwɔːkɪn
hi bi ˈbɪtʃɪn	hiːz ˈjuːʒəli ˈbɪtʃɪn
ʃi bi ˈbɪtʃɪn	ʃiːz ˈjuːʒəli ˈbɪtʃɪn
ðeɪ bi ˈbɪtʃɪn	ðeɪ ˈjuːʒəli ˈbɪtʃɪn
hi bi ˈɛvɹɪθɪn	hiːz ˈjuːʒəli ˈɛvɹɪθɪn
ʃi bi ˈɛvɹɪθɪn	ʃiːz ˈjuːʒəli ˈɛvɹɪθɪn
ðeɪ bi ˈɛvɹɪθɪn	ðeɪ ˈjuːʒəli ˈɛvɹɪθɪn
hi bi ˈkɪkɪn	hiːz ˈjuːʒəli ˈkɪkɪn
ʃi bi ˈkɪkɪn	ʃiːz ˈjuːʒəli ˈkɪkɪn
ðeɪ bi ˈkɪkɪn	ðeɪ ˈjuːʒəli ˈkɪkɪn
hi bi ˈkɪdɪn	hiːz ˈjuːʒəli ˈkɪdɪn
ʃi bi ˈkɪdɪn	ʃiːz ˈjuːʒəli ˈkɪdɪn
ðeɪ bi ˈkɪdɪn	ðeɪ ˈjuːʒəli ˈkɪdɪn
hi bi ˈbæŋɪn	hiːz ˈjuːʒəli ˈbæŋɪn
ʃi bi ˈbæŋɪn	ʃiːz ˈjuːʒəli ˈbæŋɪn
ðeɪ bi ˈbæŋɪn	ðeɪ ˈjuːʒəli ˈbæŋɪn
hi bi ˈbɹeɪkɪn	hiːz ˈjuːʒəli ˈbɹeɪkɪn
ʃi bi ˈbɹeɪkɪn	ʃiːz ˈjuːʒəli ˈbɹeɪkɪn
ðeɪ bi ˈbɹeɪkɪn	ðeɪ ˈjuːʒəli ˈbɹeɪkɪn
hi bi ˈtʃætɪn	hiːz ˈjuːʒəli ˈtʃætɪn
ʃi bi ˈtʃætɪn	ʃiːz ˈjuːʒəli ˈtʃætɪn
ðeɪ bi ˈtʃætɪn	ðeɪ ˈjuːʒəli ˈtʃætɪn
hi bi ˈeɪmɪn	hiːz ˈjuːʒəli ˈeɪmɪn
ʃi bi ˈeɪmɪn	ʃiːz ˈjuːʒəli ˈeɪmɪn
ðeɪ bi ˈeɪmɪn	ðeɪ ˈjuːʒəli ˈeɪmɪn
hi bi ˈhɛkɪn	hiːz ˈjuːʒəli ˈhɛkɪn
ʃi bi ˈhɛkɪn	ʃiːz ˈjuːʒəli ˈhɛkɪn
ðeɪ bi ˈhɛkɪn	ðeɪ ˈjuːʒəli ˈhɛkɪn
hi bi ˈstɑːtɪn	hiːz ˈjuːʒəli ˈstɑːtɪn
ʃi bi ˈstɑːtɪn	ʃiːz ˈjuːʒəli ˈstɑːtɪn
ðeɪ bi ˈstɑːtɪn	ðeɪ ˈjuːʒəli ˈstɑːtɪn
hi bi ˈtʃiːzɪn	hiːz ˈjuːʒəli ˈtʃiːzɪn
ʃi bi ˈtʃiːzɪn	ʃiːz ˈjuːʒəli ˈtʃiːzɪn
ðeɪ bi ˈtʃiːzɪn	ðeɪ ˈjuːʒəli ˈtʃiːzɪn
hi bi ˈdɹiːmɪn	hiːz ˈjuːʒəli ˈdɹiːmɪn
ʃi bi ˈdɹiːmɪn	ʃiːz ˈjuːʒəli ˈdɹiːmɪn
ðeɪ bi ˈdɹiːmɪn	ðeɪ ˈjuːʒəli ˈdɹiːmɪn
hi bi ˈfɹʌntɪn	hiːz ˈjuːʒəli ˈfɹʌntɪn
ʃi bi ˈfɹʌntɪn	ʃiːz ˈjuːʒəli ˈfɹʌntɪn
ðeɪ bi ˈfɹʌntɪn	ðeɪ ˈjuːʒəli ˈfɹʌntɪn
hi bi ˈdɹɪnkɪn	hiːz ˈjuːʒəli ˈdɹɪnkɪn
ʃi bi ˈdɹɪnkɪn	ʃiːz ˈjuːʒəli ˈdɹɪnkɪn
ðeɪ bi ˈdɹɪnkɪn	ðeɪ ˈjuːʒəli ˈdɹɪnkɪn
hi bi ˈdɑːlɪn	hiːz ˈjuːʒəli ˈdɑːlɪn
ʃi bi ˈdɑːlɪn	ʃiːz ˈjuːʒəli ˈdɑːlɪn
ðeɪ bi ˈdɑːlɪn	ðeɪ ˈjuːʒəli ˈdɑːlɪn
hi bi ˈpʊlɪn	hiːz ˈjuːʒəli ˈpʊlɪn
ʃi bi ˈpʊlɪn	ʃiːz ˈjuːʒəli ˈpʊlɪn
ðeɪ bi ˈpʊlɪn	ðeɪ ˈjuːʒəli ˈpʊlɪn
hi bi ˈtɔːkɪn	hiːz ˈjuːʒəli ˈtɔːkɪn
ʃi bi ˈtɔːkɪn	ʃiːz ˈjuːʒəli ˈtɔːkɪn
ðeɪ bi ˈtɔːkɪn	ðeɪ ˈjuːʒəli ˈtɔːkɪn
hi bi ˈhæŋɪn	hiːz ˈjuːʒəli ˈhæŋɪn
ʃi bi ˈhæŋɪn	ʃiːz ˈjuːʒəli ˈhæŋɪn
ðeɪ bi ˈhæŋɪn	ðeɪ ˈjuːʒəli ˈhæŋɪn
hi bi ?k?k?n	hi?z ?ju???li ?k?k??
?i bi ?k?k?n	?i?z ?ju???li ?k?k??
 e? bi ?k?k?n	 e? ?ju???li ?k?k??
hi bi ?ste??n	hi?z ?ju???li ?ste???
?i bi ?ste??n	?i?z ?ju???li ?ste???
 e? bi ?ste??n	 e? ?ju???li ?ste???
hi bi ?juz?n	hi?z ?ju???li ?juz??
?i bi ?juz?n	?i?z ?ju???li ?juz??
 e? bi ?juz?n	 e? ?ju???li ?juz??
hi bi ?p k?n	hi?z ?ju???li ?p k??
?i bi ?p k?n	?i?z ?ju???li ?p k??
 e? bi ?p k?n	 e? ?ju???li ?p k??
hi bi ?p?s?n	hi?z ?ju???li ?p?s??
?i bi ?p?s?n	?i?z ?ju???li ?p?s??
 e? bi ?p?s?n	 e? ?ju???li ?p?s??
hi bi ?k p?n	hi?z ?ju???li ?k p??
?i bi ?k p?n	?i?z ?ju???li ?k p??
 e? bi ?k p?n	 e? ?ju???li ?k p??
hi bi ???o??n	hi?z ?ju???li ???o???
?i bi ???o??n	?i?z ?ju???li ???o???
 e? bi ???o??n	 e? ?ju???li ???o???
hi bi ?s???n	hi?z ?ju???li ?s????
?i bi ?s???n	?i?z ?ju???li ?s????
 e? bi ?s???n	 e? ?ju???li ?s????
hi bi ?blid?n	hi?z ?ju???li ?blid??
?i bi ?blid?n	?i?z ?ju???li ?blid??
 e? bi ?blid?n	 e? ?ju???li ?blid??
hi bi ?sp?n?n	hi?z ?ju???li ?sp?n??
?i bi ?sp?n?n	?i?z ?ju???li ?sp?n??
 e? bi ?sp?n?n	 e? ?ju???li ?sp?n??
hi bi ?k??l?n	hi?z ?ju???li ?k??l??
?i bi ?k??l?n	?i?z ?ju???li ?k??l??
 e? bi ?k??l?n	 e? ?ju???li ?k??l??
hi bi ?d ns?n	hi?z ?ju???li ?d ns??
?i bi ?d ns?n	?i?z ?ju???li ?d ns??
 e? bi ?d ns?n	 e? ?ju???li ?d ns??
hi bi ?d??p?n	hi?z ?ju???li ?d??p??
?i bi ?d??p?n	?i?z ?ju???li ?d??p??
 e? bi ?d??p?n	 e? ?ju???li ?d??p??
hi bi ?? mbl?n	hi?z ?ju???li ?? mbl??
?i bi ?? mbl?n	?i?z ?ju???li ?? mbl??
 e? bi ?? mbl?n	 e? ?ju???li ?? mbl??
hi bi ?w?l?n	hi?z ?ju???li ?w?l??
?i bi ?w?l?n	?i?z ?ju???li ?w?l??
 e? bi ?w?l?n	 e? ?ju???li ?w?l??
hi bi ???t?n	hi?z ?ju???li ???t??
?i bi ???t?n	?i?z ?ju???li ???t??
 e? bi ???t?n	 e? ?ju???li ???t??
hi bi ?fl?p?n	hi?z ?ju???li ?fl?p??
?i bi ?fl?p?n	?i?z ?ju???li ?fl?p??
 e? bi ?fl?p?n	 e? ?ju???li ?fl?p??
hi bi ?da??n	hi?z ?ju???li ?da???
?i bi ?da??n	?i?z ?ju???li ?da???
 e? bi ?da??n	 e? ?ju???li ?da???
hi bi ?w???n	hi?z ?ju???li ?w????
?i bi ?w???n	?i?z ?ju???li ?w????
 e? bi ?w???n	 e? ?ju???li ?w????
hi bi ?fil?n	hi?z ?ju???li ?fil??
?i bi ?fil?n	?i?z ?ju???li ?fil??
 e? bi ?fil?n	 e? ?ju???li ?fil??
hi bi ?m?s?n	hi?z ?ju???li ?m?s??
?i bi ?m?s?n	?i?z ?ju???li ?m?s??
 e? bi ?m?s?n	 e? ?ju???li ?m?s??
hi bi ?we?v?n	hi?z ?ju???li ?we?v??
?i bi ?we?v?n	?i?z ?ju???li ?we?v??
 e? bi ?we?v?n	 e? ?ju???li ?we?v??
hi bi ?k?s?n	hi?z ?ju???li ?k?s??
?i bi ?k?s?n	?i?z ?ju???li ?k?s??
 e? bi ?k?s?n	 e? ?ju???li ?k?s??
hi bi ?b?b?n	hi?z ?ju???li ?b?b??
?i bi ?b?b?n	?i?z ?ju???li ?b?b??
 e? bi ?b?b?n	 e? ?ju???li ?b?b??
hi bi ?fl?ks?n	hi?z ?ju???li ?fl?ks??
?i bi ?fl?ks?n	?i?z ?ju???li ?fl?ks??
 e? bi ?fl?ks?n	 e? ?ju???li ?fl?ks??
hi bi ?b???n	hi?z ?ju???li ?b????
?i bi ?b???n	?i?z ?ju???li ?b????
 e? bi ?b???n	 e? ?ju???li ?b????
hi bi ?pe??n	hi?z ?ju???li ?pe???
?i bi ?pe??n	?i?z ?ju???li ?pe???
 e? bi ?pe??n	 e? ?ju???li ?pe???
hi bi ?st nd?n	hi?z ?ju???li ?st nd??
?i bi ?st nd?n	?i?z ?ju???li ?st nd??
 e? bi ?st nd?n	 e? ?ju???li ?st nd??
hi bi ?k?m?n	hi?z ?ju???li ?k?m??
?i bi ?k?m?n	?i?z ?ju???li ?k?m??
 e? bi ?k?m?n	 e? ?ju???li ?k?m??
hi bi ?f????n	hi?z ?ju???li ?f?????
?i bi ?f????n	?i?z ?ju???li ?f?????
 e? bi ?f????n	 e? ?ju???li ?f?????
hi bi ?st?p?n	hi?z ?ju???li ?st?p??
?i bi ?st?p?n	?i?z ?ju???li ?st?p??
 e? bi ?st?p?n	 e? ?ju???li ?st?p??
hi bi ?p?k?n	hi?z ?ju???li ?p?k??
?i bi ?p?k?n	?i?z ?ju???li ?p?k??
 e? bi ?p?k?n	 e? ?ju???li ?p?k??
hi bi ?p?f?n	hi?z ?ju???li ?p?f??
?i bi ?p?f?n	?i?z ?ju???li ?p?f??
 e? bi ?p?f?n	 e? ?ju???li ?p?f??
hi bi ? sk?n	hi?z ?ju???li ? sk??
?i bi ? sk?n	?i?z ?ju???li ? sk??
 e? bi ? sk?n	 e? ?ju???li ? sk??
hi bi ?m??n?n	hi?z ?ju???li ?m??n??
?i bi ?m??n?n	?i?z ?ju???li ?m??n??
 e? bi ?m??n?n	 e? ?ju???li ?m??n??
hi bi ?it?n	hi?z ?ju???li ?it??
?i bi ?it?n	?i?z ?ju???li ?it??
 e? bi ?it?n	 e? ?ju???li ?it??
hi bi ?a?s?n	hi?z ?ju???li ?a?s??
?i bi ?a?s?n	?i?z ?ju???li ?a?s??
 e? bi ?a?s?n	 e? ?ju???li ?a?s??
hi bi ?b?i ?n	hi?z ?ju???li ?b?i ??
?i bi ?b?i ?n	?i?z ?ju???li ?b?i ??
 e? bi ?b?i ?n	 e? ?ju???li ?b?i ??
hi bi ?d???n	hi?z ?ju???li ?d????
?i bi ?d???n	?i?z ?ju???li ?d????
 e? bi ?d???n	 e? ?ju???li ?d????



