hɪ bɪ ˈkɹækɪn	hiːz ˈjuːʒəli ˈkɹækɪŋ
ʃi bɪ ˈkɹækɪn	ʃiːz ˈjuːʒəli ˈkɹækɪŋ
ðeɪ bɪ ˈkɹækɪn	ðeɪər ˈjuːʒəli ˈkɹækɪŋ
hɪ bɪ ˈlʌvɪn	hiːz ˈjuːʒəli ˈlʌvɪŋ
ʃi bɪ ˈlʌvɪn	ʃiːz ˈjuːʒəli ˈlʌvɪŋ
ðeɪ bɪ ˈlʌvɪn	ðeɪər ˈjuːʒəli ˈlʌvɪŋ
hɪ bɪ ˈæktɪn	hiːz ˈjuːʒəli ˈæktɪŋ
ʃi bɪ ˈæktɪn	ʃiːz ˈjuːʒəli ˈæktɪŋ
ðeɪ bɪ ˈæktɪn	ðeɪər ˈjuːʒəli ˈæktɪŋ
hɪ bɪ ˈbloʊɪn	hiːz ˈjuːʒəli ˈbloʊɪŋ
ʃi bɪ ˈbloʊɪn	ʃiːz ˈjuːʒəli ˈbloʊɪŋ
ðeɪ bɪ ˈbloʊɪn	ðeɪər ˈjuːʒəli ˈbloʊɪŋ
hɪ bɪ ˈpleɪɪn	hiːz ˈjuːʒəli ˈpleɪɪŋ
ʃi bɪ ˈpleɪɪn	ʃiːz ˈjuːʒəli ˈpleɪɪŋ
ðeɪ bɪ ˈpleɪɪn	ðeɪər ˈjuːʒəli ˈpleɪɪŋ
hɪ bɪ ˈbɔːlɪn	hiːz ˈjuːʒəli ˈbɔːlɪŋ
ʃi bɪ ˈbɔːlɪn	ʃiːz ˈjuːʒəli ˈbɔːlɪŋ
ðeɪ bɪ ˈbɔːlɪn	ðeɪər ˈjuːʒəli ˈbɔːlɪŋ
hɪ bɪ ˈlɪnkɪn	hiːz ˈjuːʒəli ˈlɪnkɪŋ
ʃi bɪ ˈlɪnkɪn	ʃiːz ˈjuːʒəli ˈlɪnkɪŋ
ðeɪ bɪ ˈlɪnkɪn	ðeɪər ˈjuːʒəli ˈlɪnkɪŋ
hɪ bɪ ˈheɪtɪn	hiːz ˈjuːʒəli ˈheɪtɪŋ
ʃi bɪ ˈheɪtɪn	ʃiːz ˈjuːʒəli ˈheɪtɪŋ
ðeɪ bɪ ˈheɪtɪn	ðeɪər ˈjuːʒəli ˈheɪtɪŋ
hɪ bɪ ˈbʌstɪn	hiːz ˈjuːʒəli ˈbʌstɪŋ
ʃi bɪ ˈbʌstɪn	ʃiːz ˈjuːʒəli ˈbʌstɪŋ
ðeɪ bɪ ˈbʌstɪn	ðeɪər ˈjuːʒəli ˈbʌstɪŋ
hɪ bɪ ˈbʌɡɪn	hiːz ˈjuːʒəli ˈbʌɡɪŋ
ʃi bɪ ˈbʌɡɪn	ʃiːz ˈjuːʒəli ˈbʌɡɪŋ
ðeɪ bɪ ˈbʌɡɪn	ðeɪər ˈjuːʒəli ˈbʌɡɪŋ
hɪ bɪ ˈfuːlɪn	hiːz ˈjuːʒəli ˈfuːlɪŋ
ʃi bɪ ˈfuːlɪn	ʃiːz ˈjuːʒəli ˈfuːlɪŋ
ðeɪ bɪ ˈfuːlɪn	ðeɪər ˈjuːʒəli ˈfuːlɪŋ
hɪ bɪ ˈvaɪbɪn	hiːz ˈjuːʒəli ˈvaɪbɪŋ
ʃi bɪ ˈvaɪbɪn	ʃiːz ˈjuːʒəli ˈvaɪbɪŋ
ðeɪ bɪ ˈvaɪbɪn	ðeɪər ˈjuːʒəli ˈvaɪbɪŋ
hɪ bɪ ˈɹæpɪn	hiːz ˈjuːʒəli ˈɹæpɪŋ
ʃi bɪ ˈɹæpɪn	ʃiːz ˈjuːʒəli ˈɹæpɪŋ
ðeɪ bɪ ˈɹæpɪn	ðeɪər ˈjuːʒəli ˈɹæpɪŋ
hɪ bɪ ˈblæstɪn	hiːz ˈjuːʒəli ˈblæstɪŋ
ʃi bɪ ˈblæstɪn	ʃiːz ˈjuːʒəli ˈblæstɪŋ
ðeɪ bɪ ˈblæstɪn	ðeɪər ˈjuːʒəli ˈblæstɪŋ
hɪ bɪ ˈsleɪɪn	hiːz ˈjuːʒəli ˈsleɪɪŋ
ʃi bɪ ˈsleɪɪn	ʃiːz ˈjuːʒəli ˈsleɪɪŋ
ðeɪ bɪ ˈsleɪɪn	ðeɪər ˈjuːʒəli ˈsleɪɪŋ
hɪ bɪ ˈwɪpɪn	hiːz ˈjuːʒəli ˈwɪpɪŋ
ʃi bɪ ˈwɪpɪn	ʃiːz ˈjuːʒəli ˈwɪpɪŋ
ðeɪ bɪ ˈwɪpɪn	ðeɪər ˈjuːʒəli ˈwɪpɪŋ
hɪ bɪ ˈfaɪndɪn	hiːz ˈjuːʒəli ˈfaɪndɪŋ
ʃi bɪ ˈfaɪndɪn	ʃiːz ˈjuːʒəli ˈfaɪndɪŋ
ðeɪ bɪ ˈfaɪndɪn	ðeɪər ˈjuːʒəli ˈfaɪndɪŋ
hɪ bɪ ˈpɑːkɪn	hiːz ˈjuːʒəli ˈpɑːkɪŋ
ʃi bɪ ˈpɑːkɪn	ʃiːz ˈjuːʒəli ˈpɑːkɪŋ
ðeɪ bɪ ˈpɑːkɪn	ðeɪər ˈjuːʒəli ˈpɑːkɪŋ
hɪ bɪ ˈkɹiːpɪn	hiːz ˈjuːʒəli ˈkɹiːpɪŋ
ʃi bɪ ˈkɹiːpɪn	ʃiːz ˈjuːʒəli ˈkɹiːpɪŋ
ðeɪ bɪ ˈkɹiːpɪn	ðeɪər ˈjuːʒəli ˈkɹiːpɪŋ
hɪ bɪ ˈfɹɪkɪn	hiːz ˈjuːʒəli ˈfɹɪkɪŋ
ʃi bɪ ˈfɹɪkɪn	ʃiːz ˈjuːʒəli ˈfɹɪkɪŋ
ðeɪ bɪ ˈfɹɪkɪn	ðeɪər ˈjuːʒəli ˈfɹɪkɪŋ
hɪ bɪ ˈdɹɪpɪn	hiːz ˈjuːʒəli ˈdɹɪpɪŋ
ʃi bɪ ˈdɹɪpɪn	ʃiːz ˈjuːʒəli ˈdɹɪpɪŋ
ðeɪ bɪ ˈdɹɪpɪn	ðeɪər ˈjuːʒəli ˈdɹɪpɪŋ
hɪ bɪ ˈstɪtʃɪn	hiːz ˈjuːʒəli ˈstɪtʃɪŋ
ʃi bɪ ˈstɪtʃɪn	ʃiːz ˈjuːʒəli ˈstɪtʃɪŋ
ðeɪ bɪ ˈstɪtʃɪn	ðeɪər ˈjuːʒəli ˈstɪtʃɪŋ
hɪ bɪ ˈkɪlɪn	hiːz ˈjuːʒəli ˈkɪlɪŋ
ʃi bɪ ˈkɪlɪn	ʃiːz ˈjuːʒəli ˈkɪlɪŋ
ðeɪ bɪ ˈkɪlɪn	ðeɪər ˈjuːʒəli ˈkɪlɪŋ
hɪ bɪ bɪˈliːvɪn	hiːz ˈjuːʒəli bɪˈliːvɪŋ
ʃi bɪ bɪˈliːvɪn	ʃiːz ˈjuːʒəli bɪˈliːvɪŋ
ðeɪ bɪ bɪˈliːvɪn	ðeɪər ˈjuːʒəli bɪˈliːvɪŋ
hɪ bɪ ˈkʌtɪn	hiːz ˈjuːʒəli ˈkʌtɪŋ
ʃi bɪ ˈkʌtɪn	ʃiːz ˈjuːʒəli ˈkʌtɪŋ
ðeɪ bɪ ˈkʌtɪn	ðeɪər ˈjuːʒəli ˈkʌtɪŋ
hɪ bɪ ˈɡɛtɪn	hiːz ˈjuːʒəli ˈɡɛtɪŋ
ʃi bɪ ˈɡɛtɪn	ʃiːz ˈjuːʒəli ˈɡɛtɪŋ
ðeɪ bɪ ˈɡɛtɪn	ðeɪər ˈjuːʒəli ˈɡɛtɪŋ
hɪ bɪ ˈɹaɪdɪn	hiːz ˈjuːʒəli ˈɹaɪdɪŋ
ʃi bɪ ˈɹaɪdɪn	ʃiːz ˈjuːʒəli ˈɹaɪdɪŋ
ðeɪ bɪ ˈɹaɪdɪn	ðeɪər ˈjuːʒəli ˈɹaɪdɪŋ
hɪ bɪ ˈwɔːkɪn	hiːz ˈjuːʒəli ˈwɔːkɪŋ
ʃi bɪ ˈwɔːkɪn	ʃiːz ˈjuːʒəli ˈwɔːkɪŋ
ðeɪ bɪ ˈwɔːkɪn	ðeɪər ˈjuːʒəli ˈwɔːkɪŋ
hɪ bɪ ˈbɪtʃɪn	hiːz ˈjuːʒəli ˈbɪtʃɪŋ
ʃi bɪ ˈbɪtʃɪn	ʃiːz ˈjuːʒəli ˈbɪtʃɪŋ
ðeɪ bɪ ˈbɪtʃɪn	ðeɪər ˈjuːʒəli ˈbɪtʃɪŋ
hɪ bɪ ˈɛvɹɪθɪn	hiːz ˈjuːʒəli ˈɛvɹɪθɪŋ
ʃi bɪ ˈɛvɹɪθɪn	ʃiːz ˈjuːʒəli ˈɛvɹɪθɪŋ
ðeɪ bɪ ˈɛvɹɪθɪn	ðeɪər ˈjuːʒəli ˈɛvɹɪθɪŋ
hɪ bɪ ˈkɪkɪn	hiːz ˈjuːʒəli ˈkɪkɪŋ
ʃi bɪ ˈkɪkɪn	ʃiːz ˈjuːʒəli ˈkɪkɪŋ
ðeɪ bɪ ˈkɪkɪn	ðeɪər ˈjuːʒəli ˈkɪkɪŋ
hɪ bɪ ˈkɛdɪn	hiːz ˈjuːʒəli ˈkɛdɪŋ
ʃi bɪ ˈkɛdɪn	ʃiːz ˈjuːʒəli ˈkɛdɪŋ
ðeɪ bɪ ˈkɛdɪn	ðeɪər ˈjuːʒəli ˈkɛdɪŋ
hɪ bɪ ˈbæŋɪn	hiːz ˈjuːʒəli ˈbæŋɪŋ
ʃi bɪ ˈbæŋɪn	ʃiːz ˈjuːʒəli ˈbæŋɪŋ
ðeɪ bɪ ˈbæŋɪn	ðeɪər ˈjuːʒəli ˈbæŋɪŋ
hɪ bɪ ˈbɹeɪkɪn	hiːz ˈjuːʒəli ˈbɹeɪkɪŋ
ʃi bɪ ˈbɹeɪkɪn	ʃiːz ˈjuːʒəli ˈbɹeɪkɪŋ
ðeɪ bɪ ˈbɹeɪkɪn	ðeɪər ˈjuːʒəli ˈbɹeɪkɪŋ
hɪ bɪ ˈtʃætɪn	hiːz ˈjuːʒəli ˈtʃætɪŋ
ʃi bɪ ˈtʃætɪn	ʃiːz ˈjuːʒəli ˈtʃætɪŋ
ðeɪ bɪ ˈtʃætɪn	ðeɪər ˈjuːʒəli ˈtʃætɪŋ
hɪ bɪ ˈeɪməzɪn	hiːz ˈjuːʒəli ˈeɪməzɪŋ
ʃi bɪ ˈeɪməzɪn	ʃiːz ˈjuːʒəli ˈeɪməzɪŋ
ðeɪ bɪ ˈeɪməzɪn	ðeɪər ˈjuːʒəli ˈeɪməzɪŋ
hɪ bɪ ˈhɛkɪn	hiːz ˈjuːʒəli ˈhɛkɪŋ
ʃi bɪ ˈhɛkɪn	ʃiːz ˈjuːʒəli ˈhɛkɪŋ
ðeɪ bɪ ˈhɛkɪn	ðeɪər ˈjuːʒəli ˈhɛkɪŋ
hɪ bɪ ˈstɑːtɪn	hiːz ˈjuːʒəli ˈstɑːtɪŋ
ʃi bɪ ˈstɑːtɪn	ʃiːz ˈjuːʒəli ˈstɑːtɪŋ
ðeɪ bɪ ˈstɑːtɪn	ðeɪər ˈjuːʒəli ˈstɑːtɪŋ
hɪ bɪ ˈtʃiːzɪn	hiːz ˈjuːʒəli ˈtʃiːzɪŋ
ʃi bɪ ˈtʃiːzɪn	ʃiːz ˈjuːʒəli ˈtʃiːzɪŋ
ðeɪ bɪ ˈtʃiːzɪn	ðeɪər ˈjuːʒəli ˈtʃiːzɪŋ
hɪ bɪ ˈdɹiːmɪn	hiːz ˈjuːʒəli ˈdɹiːmɪŋ
ʃi bɪ ˈdɹiːmɪn	ʃiːz ˈjuːʒəli ˈdɹiːmɪŋ
ðeɪ bɪ ˈdɹiːmɪn	ðeɪər ˈjuːʒəli ˈdɹiːmɪŋ
hɪ bɪ ˈfɹʌntɪn	hiːz ˈjuːʒəli ˈfɹʌntɪŋ
ʃi bɪ ˈfɹʌntɪn	ʃiːz ˈjuːʒəli ˈfɹʌntɪŋ
ðeɪ bɪ ˈfɹʌntɪn	ðeɪər ˈjuːʒəli ˈfɹʌntɪŋ
hɪ bɪ ˈdɹɪŋkɪn	hiːz ˈjuːʒəli ˈdɹɪŋkɪŋ
ʃi bɪ ˈdɹɪŋkɪn	ʃiːz ˈjuːʒəli ˈdɹɪŋkɪŋ
ðeɪ bɪ ˈdɹɪŋkɪn	ðeɪər ˈjuːʒəli ˈdɹɪŋkɪŋ
hɪ bɪ ˈdɑːlɪn	hiːz ˈjuːʒəli ˈdɑːlɪŋ
ʃi bɪ ˈdɑːlɪn	ʃiːz ˈjuːʒəli ˈdɑːlɪŋ
ðeɪ bɪ ˈdɑːlɪn	ðeɪər ˈjuːʒəli ˈdɑːlɪŋ
hɪ bɪ ˈpʊlɪn	hiːz ˈjuːʒəli ˈpʊlɪŋ
ʃi bɪ ˈpʊlɪn	ʃiːz ˈjuːʒəli ˈpʊlɪŋ
ðeɪ bɪ ˈpʊlɪn	ðeɪər ˈjuːʒəli ˈpʊlɪŋ
hɪ bɪ ˈtɔːkɪn	hiːz ˈjuːʒəli ˈtɔːkɪŋ
ʃi bɪ ˈtɔːkɪn	ʃiːz ˈjuːʒəli ˈtɔːkɪŋ
ðeɪ bɪ ˈtɔːkɪn	ðeɪər ˈjuːʒəli ˈtɔːkɪŋ
hɪ bɪ ˈhæŋɪn	hiːz ˈjuːʒəli ˈhæŋɪŋ
ʃi bɪ ˈhæŋɪn	ʃiːz ˈjuːʒəli ˈhæŋɪŋ
ðeɪ bɪ ˈhæŋɪn	ðeɪər ˈjuːʒəli ˈhæŋɪŋ
hi bi ˈkʊkɪn	hiːz ˈjuːʒəli ˈkʊkɪŋ
ʃi bi ˈkʊkɪn	ʃiːz ˈjuːʒəli ˈkʊkɪŋ
ðeɪ bi ˈkʊkɪn	ðeɪ ˈjuːʒəli ˈkʊkɪŋ
hi bi ˈsteɪɪn	hiːz ˈjuːʒəli ˈsteɪɪŋ
ʃi bi ˈsteɪɪn	ʃiːz ˈjuːʒəli ˈsteɪɪŋ
ðeɪ bi ˈsteɪɪn	ðeɪ ˈjuːʒəli ˈsteɪɪŋ
hi bi ˈjuzɪn	hiːz ˈjuːʒəli ˈjuzɪŋ
ʃi bi ˈjuzɪn	ʃiːz ˈjuːʒəli ˈjuzɪŋ
ðeɪ bi ˈjuzɪn	ðeɪ ˈjuːʒəli ˈjuzɪŋ
hi bi ˈpækɪn	hiːz ˈjuːʒəli ˈpækɪŋ
ʃi bi ˈpækɪn	ʃiːz ˈjuːʒəli ˈpækɪŋ
ðeɪ bi ˈpækɪn	ðeɪ ˈjuːʒəli ˈpækɪŋ
hi bi ˈpɪsɪn	hiːz ˈjuːʒəli ˈpɪsɪŋ
ʃi bi ˈpɪsɪn	ʃiːz ˈjuːʒəli ˈpɪsɪŋ
ðeɪ bi ˈpɪsɪn	ðeɪ ˈjuːʒəli ˈpɪsɪŋ
hi bi ˈkæpɪn	hiːz ˈjuːʒəli ˈkæpɪŋ
ʃi bi ˈkæpɪn	ʃiːz ˈjuːʒəli ˈkæpɪŋ
ðeɪ bi ˈkæpɪn	ðeɪ ˈjuːʒəli ˈkæpɪŋ
hi bi ˈθɹoʊɪn	hiːz ˈjuːʒəli ˈθɹoʊɪŋ
ʃi bi ˈθɹoʊɪn	ʃiːz ˈjuːʒəli ˈθɹoʊɪŋ
ðeɪ bi ˈθɹoʊɪn	ðeɪ ˈjuːʒəli ˈθɹoʊɪŋ
hi bi ˈsɪŋɪn	hiːz ˈjuːʒəli ˈsɪŋɪŋ
ʃi bi ˈsɪŋɪn	ʃiːz ˈjuːʒəli ˈsɪŋɪŋ
ðeɪ bi ˈsɪŋɪn	ðeɪ ˈjuːʒəli ˈsɪŋɪŋ
hi bi ˈblidɪn	hiːz ˈjuːʒəli ˈblidɪŋ
ʃi bi ˈblidɪn	ʃiːz ˈjuːʒəli ˈblidɪŋ
ðeɪ bi ˈblidɪn	ðeɪ ˈjuːʒəli ˈblidɪŋ
hi bi ˈspɪnɪn	hiːz ˈjuːʒəli ˈspɪnɪŋ
ʃi bi ˈspɪnɪn	ʃiːz ˈjuːʒəli ˈspɪnɪŋ
ðeɪ bi ˈspɪnɪn	ðeɪ ˈjuːʒəli ˈspɪnɪŋ
hi bi ˈkɔːlɪn	hiːz ˈjuːʒəli ˈkɔːlɪŋ
ʃi bi ˈkɔːlɪn	ʃiːz ˈjuːʒəli ˈkɔːlɪŋ
ðeɪ bi ˈkɔːlɪn	ðeɪ ˈjuːʒəli ˈkɔːlɪŋ
hi bi ˈdænsɪn	hiːz ˈjuːʒəli ˈdænsɪŋ
ʃi bi ˈdænsɪn	ʃiːz ˈjuːʒəli ˈdænsɪŋ
ðeɪ bi ˈdænsɪn	ðeɪ ˈjuːʒəli ˈdænsɪŋ
hi bi ˈdɹɒpɪn	hiːz ˈjuːʒəli ˈdɹɒpɪŋ
ʃi bi ˈdɹɒpɪn	ʃiːz ˈjuːʒəli ˈdɹɒpɪŋ
ðeɪ bi ˈdɹɒpɪn	ðeɪ ˈjuːʒəli ˈdɹɒpɪŋ
hi bi ˈɹæmblɪn	hiːz ˈjuːʒəli ˈɹæmblɪŋ
ʃi bi ˈɹæmblɪn	ʃiːz ˈjuːʒəli ˈɹæmblɪŋ
ðeɪ bi ˈɹæmblɪn	ðeɪ ˈjuːʒəli ˈɹæmblɪŋ
hi bi ˈwɪlɪn	hiːz ˈjuːʒəli ˈwɪlɪŋ
ʃi bi ˈwɪlɪn	ʃiːz ˈjuːʒəli ˈwɪlɪŋ
ðeɪ bi ˈwɪlɪn	ðeɪ ˈjuːʒəli ˈwɪlɪŋ
hi bi ˈʃɪtɪn	hiːz ˈjuːʒəli ˈʃɪtɪŋ
ʃi bi ˈʃɪtɪn	ʃiːz ˈjuːʒəli ˈʃɪtɪŋ
ðeɪ bi ˈʃɪtɪn	ðeɪ ˈjuːʒəli ˈʃɪtɪŋ
hi bi ˈflɪpɪn	hiːz ˈjuːʒəli ˈflɪpɪŋ
ʃi bi ˈflɪpɪn	ʃiːz ˈjuːʒəli ˈflɪpɪŋ
ðeɪ bi ˈflɪpɪn	ðeɪ ˈjuːʒəli ˈflɪpɪŋ
hi bi ˈdaɪɪn	hiːz ˈjuːʒəli ˈdaɪɪŋ
ʃi bi ˈdaɪɪn	ʃiːz ˈjuːʒəli ˈdaɪɪŋ
ðeɪ bi ˈdaɪɪn	ðeɪ ˈjuːʒəli ˈdaɪɪŋ
hi bi ˈwɒʧɪn	hiːz ˈjuːʒəli ˈwɒʧɪŋ
ʃi bi ˈwɒʧɪn	ʃiːz ˈjuːʒəli ˈwɒʧɪŋ
ðeɪ bi ˈwɒʧɪn	ðeɪ ˈjuːʒəli ˈwɒʧɪŋ
hi bi ˈfilɪn	hiːz ˈjuːʒəli ˈfilɪŋ
ʃi bi ˈfilɪn	ʃiːz ˈjuːʒəli ˈfilɪŋ
ðeɪ bi ˈfilɪn	ðeɪ ˈjuːʒəli ˈfilɪŋ
hi bi ˈmɪsɪn	hiːz ˈjuːʒəli ˈmɪsɪŋ
ʃi bi ˈmɪsɪn	ʃiːz ˈjuːʒəli ˈmɪsɪŋ
ðeɪ bi ˈmɪsɪn	ðeɪ ˈjuːʒəli ˈmɪsɪŋ
hi bi ˈweɪvɪn	hiːz ˈjuːʒəli ˈweɪvɪŋ
ʃi bi ˈweɪvɪn	ʃiːz ˈjuːʒəli ˈweɪvɪŋ
ðeɪ bi ˈweɪvɪn	ðeɪ ˈjuːʒəli ˈweɪvɪŋ
hi bi ˈkʌsɪn	hiːz ˈjuːʒəli ˈkʌsɪŋ
ʃi bi ˈkʌsɪn	ʃiːz ˈjuːʒəli ˈkʌsɪŋ
ðeɪ bi ˈkʌsɪn	ðeɪ ˈjuːʒəli ˈkʌsɪŋ
hi bi ˈbɒbɪn	hiːz ˈjuːʒəli ˈbɒbɪŋ
ʃi bi ˈbɒbɪn	ʃiːz ˈjuːʒəli ˈbɒbɪŋ
ðeɪ bi ˈbɒbɪn	ðeɪ ˈjuːʒəli ˈbɒbɪŋ
hi bi ˈflɛksɪn	hiːz ˈjuːʒəli ˈflɛksɪŋ
ʃi bi ˈflɛksɪn	ʃiːz ˈjuːʒəli ˈflɛksɪŋ
ðeɪ bi ˈflɛksɪn	ðeɪ ˈjuːʒəli ˈflɛksɪŋ
hi bi ˈbɛɡɪn	hiːz ˈjuːʒəli ˈbɛɡɪŋ
ʃi bi ˈbɛɡɪn	ʃiːz ˈjuːʒəli ˈbɛɡɪŋ
ðeɪ bi ˈbɛɡɪn	ðeɪ ˈjuːʒəli ˈbɛɡɪŋ
hi bi ˈpeɪɪn	hiːz ˈjuːʒəli ˈpeɪɪŋ
ʃi bi ˈpeɪɪn	ʃiːz ˈjuːʒəli ˈpeɪɪŋ
ðeɪ bi ˈpeɪɪn	ðeɪ ˈjuːʒəli ˈpeɪɪŋ
hi bi ˈstændɪn	hiːz ˈjuːʒəli ˈstændɪŋ
ʃi bi ˈstændɪn	ʃiːz ˈjuːʒəli ˈstændɪŋ
ðeɪ bi ˈstændɪn	ðeɪ ˈjuːʒəli ˈstændɪŋ
hi bi ˈkʌmɪn	hiːz ˈjuːʒəli ˈkʌmɪŋ
ʃi bi ˈkʌmɪn	ʃiːz ˈjuːʒəli ˈkʌmɪŋ
ðeɪ bi ˈkʌmɪn	ðeɪ ˈjuːʒəli ˈkʌmɪŋ
hi bi ˈfɹɪɡɪn	hiːz ˈjuːʒəli ˈfɹɪɡɪŋ
ʃi bi ˈfɹɪɡɪn	ʃiːz ˈjuːʒəli ˈfɹɪɡɪŋ
ðeɪ bi ˈfɹɪɡɪn	ðeɪ ˈjuːʒəli ˈfɹɪɡɪŋ
hi bi ˈstɛpɪn	hiːz ˈjuːʒəli ˈstɛpɪŋ
ʃi bi ˈstɛpɪn	ʃiːz ˈjuːʒəli ˈstɛpɪŋ
ðeɪ bi ˈstɛpɪn	ðeɪ ˈjuːʒəli ˈstɛpɪŋ
hi bi ˈpɪkɪn	hiːz ˈjuːʒəli ˈpɪkɪŋ
ʃi bi ˈpɪkɪn	ʃiːz ˈjuːʒəli ˈpɪkɪŋ
ðeɪ bi ˈpɪkɪn	ðeɪ ˈjuːʒəli ˈpɪkɪŋ
hi bi ˈpʌfɪn	hiːz ˈjuːʒəli ˈpʌfɪŋ
ʃi bi ˈpʌfɪn	ʃiːz ˈjuːʒəli ˈpʌfɪŋ
ðeɪ bi ˈpʌfɪn	ðeɪ ˈjuːʒəli ˈpʌfɪŋ
hi bi ˈæskɪn	hiːz ˈjuːʒəli ˈæskɪŋ
ʃi bi ˈæskɪn	ʃiːz ˈjuːʒəli ˈæskɪŋ
ðeɪ bi ˈæskɪn	ðeɪ ˈjuːʒəli ˈæskɪŋ
hi bi ˈmɔːnɪn	hiːz ˈjuːʒəli ˈmɔːnɪŋ
ʃi bi ˈmɔːnɪn	ʃiːz ˈjuːʒəli ˈmɔːnɪŋ
ðeɪ bi ˈmɔːnɪn	ðeɪ ˈjuːʒəli ˈmɔːnɪŋ
hi bi ˈitɪn	hiːz ˈjuːʒəli ˈitɪŋ
ʃi bi ˈitɪn	ʃiːz ˈjuːʒəli ˈitɪŋ
ðeɪ bi ˈitɪn	ðeɪ ˈjuːʒəli ˈitɪŋ
hi bi ˈaɪsɪn	hiːz ˈjuːʒəli ˈaɪsɪŋ
ʃi bi ˈaɪsɪn	ʃiːz ˈjuːʒəli ˈaɪsɪŋ
ðeɪ bi ˈaɪsɪn	ðeɪ ˈjuːʒəli ˈaɪsɪŋ
hi bi ˈbɹiðɪn	hiːz ˈjuːʒəli ˈbɹiðɪŋ
ʃi bi ˈbɹiðɪn	ʃiːz ˈjuːʒəli ˈbɹiðɪŋ
ðeɪ bi ˈbɹiðɪn	ðeɪ ˈjuːʒəli ˈbɹiðɪŋ
hi bi ˈdɪɡɪn	hiːz ˈjuːʒəli ˈdɪɡɪŋ
ʃi bi ˈdɪɡɪn	ʃiːz ˈjuːʒəli ˈdɪɡɪŋ
ðeɪ bi ˈdɪɡɪn	ðeɪ ˈjuːʒəli ˈdɪɡɪŋ
hi bi ˈlæfɪn	hiːz ˈjuːʒəli ˈlæfɪŋ
ʃi bi ˈlæfɪn	ʃiːz ˈjuːʒəli ˈlæfɪŋ
ðeɪ bi ˈlæfɪn	ðeɪ ˈjuːʒəli ˈlæfɪŋ
hi bi ˈʃaɪnɪn	hiːz ˈjuːʒəli ˈʃaɪnɪŋ
ʃi bi ˈʃaɪnɪn	ʃiːz ˈjuːʒəli ˈʃaɪnɪŋ
ðeɪ bi ˈʃaɪnɪn	ðeɪ ˈjuːʒəli ˈʃaɪnɪŋ
hi bi ˈpɪmpɪn	hiːz ˈjuːʒəli ˈpɪmpɪŋ
ʃi bi ˈpɪmpɪn	ʃiːz ˈjuːʒəli ˈpɪmpɪŋ
ðeɪ bi ˈpɪmpɪn	ðeɪ ˈjuːʒəli ˈpɪmpɪŋ
hi bi ˈkæʧɪn	hiːz ˈjuːʒəli ˈkæʧɪŋ
ʃi bi ˈkæʧɪn	ʃiːz ˈjuːʒəli ˈkæʧɪŋ
ðeɪ bi ˈkæʧɪn	ðeɪ ˈjuːʒəli ˈkæʧɪŋ
hi bi ˈseɪɪn	hiːz ˈjuːʒəli ˈseɪɪŋ
ʃi bi ˈseɪɪn	ʃiːz ˈjuːʒəli ˈseɪɪŋ
ðeɪ bi ˈseɪɪn	ðeɪ ˈjuːʒəli ˈseɪɪŋ
hi bi ˈʤʌmpɪn	hiːz ˈjuːʒəli ˈʤʌmpɪŋ
ʃi bi ˈʤʌmpɪn	ʃiːz ˈjuːʒəli ˈʤʌmpɪŋ
ðeɪ bi ˈʤʌmpɪn	ðeɪ ˈjuːʒəli ˈʤʌmpɪŋ
hi bi ˈfeɪkɪn	hiːz ˈjuːʒəli ˈfeɪkɪŋ
ʃi bi ˈfeɪkɪn	ʃiːz ˈjuːʒəli ˈfeɪkɪŋ
ðeɪ bi ˈfeɪkɪn	ðeɪ ˈjuːʒəli ˈfeɪkɪŋ
hi bi ˈnɒkɪn	hiːz ˈjuːʒəli ˈnɒkɪŋ
ʃi bi ˈnɒkɪn	ʃiːz ˈjuːʒəli ˈnɒkɪŋ
ðeɪ bi ˈnɒkɪn	ðeɪ ˈjuːʒəli ˈnɒkɪŋ
hi bi ˈɹɒkɪn	hiːz ˈjuːʒəli ˈɹɒkɪŋ
ʃi bi ˈɹɒkɪn	ʃiːz ˈjuːʒəli ˈɹɒkɪŋ
ðeɪ bi ˈɹɒkɪn	ðeɪ ˈjuːʒəli ˈɹɒkɪŋ
hi bi ˈsʌmɪn	hiːz ˈjuːʒəli ˈsʌmɪŋ
ʃi bi ˈsʌmɪn	ʃiːz ˈjuːʒəli ˈsʌmɪŋ
ðeɪ bi ˈsʌmɪn	ðeɪ ˈjuːʒəli ˈsʌmɪŋ
hi bi ˈsɛlɪn	hiːz ˈjuːʒəli ˈsɛlɪŋ
ʃi bi ˈsɛlɪn	ʃiːz ˈjuːʒəli ˈsɛlɪŋ
ðeɪ bi ˈsɛlɪn	ðeɪ ˈjuːʒəli ˈsɛlɪŋ
hi bi ˈɛfɪn	hiːz ˈjuːʒəli ˈɛfɪŋ
ʃi bi ˈɛfɪn	ʃiːz ˈjuːʒəli ˈɛfɪŋ
ðeɪ bi ˈɛfɪn	ðeɪ ˈjuːʒəli ˈɛfɪŋ
hi bi ˈɡoʊstɪn	hiːz ˈjuːʒəli ˈɡoʊstɪŋ
ʃi bi ˈɡoʊstɪn	ʃiːz ˈjuːʒəli ˈɡoʊstɪŋ
ðeɪ bi ˈɡoʊstɪn	ðeɪ ˈjuːʒəli ˈɡoʊstɪŋ
hi bi ˈlivɪn	hiːz ˈjuːʒəli ˈlivɪŋ
ʃi bi ˈlivɪn	ʃiːz ˈjuːʒəli ˈlivɪŋ
ðeɪ bi ˈlivɪn	ðeɪ ˈjuːʒəli ˈlivɪŋ
hi bi ˈsmoʊkɪn	hiːz ˈjuːʒəli ˈsmoʊkɪŋ
ʃi bi ˈsmoʊkɪn	ʃiːz ˈjuːʒəli ˈsmoʊkɪŋ
ðeɪ bi ˈsmoʊkɪn	ðeɪ ˈjuːʒəli ˈsmoʊkɪŋ
hi bi ˈweɪtɪn	hiːz ˈjuːʒəli ˈweɪtɪŋ
ʃi bi ˈweɪtɪn	ʃiːz ˈjuːʒəli ˈweɪtɪŋ
ðeɪ bi ˈweɪtɪn	ðeɪ ˈjuːʒəli ˈweɪtɪŋ
hi bi ˈslɪpɪn	hiːz ˈjuːʒəli ˈslɪpɪŋ
ʃi bi ˈslɪpɪn	ʃiːz ˈjuːʒəli ˈslɪpɪŋ
ðeɪ bi ˈslɪpɪn	ðeɪ ˈjuːʒəli ˈslɪpɪŋ
hi bi ˈfleɪmɪn	hiːz ˈjuːʒəli ˈfleɪmɪŋ
ʃi bi ˈfleɪmɪn	ʃiːz ˈjuːʒəli ˈfleɪmɪŋ
ðeɪ bi ˈfleɪmɪn	ðeɪ ˈjuːʒəli ˈfleɪmɪŋ
hi bi ˈbleɪzɪn	hiːz ˈjuːʒəli ˈbleɪzɪŋ
ʃi bi ˈbleɪzɪn	ʃiːz ˈjuːʒəli ˈbleɪzɪŋ
ðeɪ bi ˈbleɪzɪn	ðeɪ ˈjuːʒəli ˈbleɪzɪŋ
hi bi ˈbɹɪŋɪn	hiːz ˈjuːʒəli ˈbɹɪŋɪŋ
ʃi bi ˈbɹɪŋɪn	ʃiːz ˈjuːʒəli ˈbɹɪŋɪŋ
ðeɪ bi ˈbɹɪŋɪn	ðeɪ ˈjuːʒəli ˈbɹɪŋɪŋ
hi bi ˈʧɛkɪn	hiːz ˈjuːʒəli ˈʧɛkɪŋ
ʃi bi ˈʧɛkɪn	ʃiːz ˈjuːʒəli ˈʧɛkɪŋ
ðeɪ bi ˈʧɛkɪn	ðeɪ ˈjuːʒəli ˈʧɛkɪŋ
hi bi ˈbɪɡɪn	hiːz ˈjuːʒəli ˈbɪɡɪŋ
ʃi bi ˈbɪɡɪn	ʃiːz ˈjuːʒəli ˈbɪɡɪŋ
ðeɪ bi ˈbɪɡɪn	ðeɪ ˈjuːʒəli ˈbɪɡɪŋ
hi bi ˈsɪtɪn	hiːz ˈjuːʒəli ˈsɪtɪŋ
ʃi bi ˈsɪtɪn	ʃiːz ˈjuːʒəli ˈsɪtɪŋ
ðeɪ bi ˈsɪtɪn	ðeɪ ˈjuːʒəli ˈsɪtɪŋ
hi bi ˈbɜːnɪn	hiːz ˈjuːʒəli ˈbɜːnɪŋ
ʃi bi ˈbɜːnɪn	ʃiːz ˈjuːʒəli ˈbɜːnɪŋ
ðeɪ bi ˈbɜːnɪn	ðeɪ ˈjuːʒəli ˈbɜːnɪŋ
hi bi ˈɡɹitɪn	hiːz ˈjuːʒəli ˈɡɹitɪŋ
ʃi bi ˈɡɹitɪn	ʃiːz ˈjuːʒəli ˈɡɹitɪŋ
ðeɪ bi ˈɡɹitɪn	ðeɪ ˈjuːʒəli ˈɡɹitɪŋ
hi bi ˈfɔːlɪn	hiːz ˈjuːʒəli ˈfɔːlɪŋ
ʃi bi ˈfɔːlɪn	ʃiːz ˈjuːʒəli ˈfɔːlɪŋ
ðeɪ bi ˈfɔːlɪn	ðeɪ ˈjuːʒəli ˈfɔːlɪŋ
hi bi ˈnʌθɪn	hiːz ˈjuːʒəli ˈnʌθɪŋ
ʃi bi ˈnʌθɪn	ʃiːz ˈjuːʒəli ˈnʌθɪŋ
ðeɪ bi ˈnʌθɪn	ðeɪ ˈjuːʒəli ˈnʌθɪŋ
hi bi ˈpɹeɪɪn	hiːz ˈjuːʒəli ˈpɹeɪɪŋ
ʃi bi ˈpɹeɪɪn	ʃiːz ˈjuːʒəli ˈpɹeɪɪŋ
ðeɪ bi ˈpɹeɪɪn	ðeɪ ˈjuːʒəli ˈpɹeɪɪŋ
hi bi ˈmɛsɪn	hiːz ˈjuːʒəli ˈmɛsɪŋ
ʃi bi ˈmɛsɪn	ʃiːz ˈjuːʒəli ˈmɛsɪŋ
ðeɪ bi ˈmɛsɪn	ðeɪ ˈjuːʒəli ˈmɛsɪŋ
hi bi ˈmuːvɪn	hiːz ˈjuːʒəli ˈmuːvɪŋ
ʃi bi ˈmuːvɪn	ʃiːz ˈjuːʒəli ˈmuːvɪŋ
ðeɪ bi ˈmuːvɪn	ðeɪ ˈjuːʒəli ˈmuːvɪŋ
hi bi ˈlʊkɪn	hiːz ˈjuːʒəli ˈlʊkɪŋ
ʃi bi ˈlʊkɪn	ʃiːz ˈjuːʒəli ˈlʊkɪŋ
ðeɪ bi ˈlʊkɪn	ðeɪ ˈjuːʒəli ˈlʊkɪŋ
hi bi ˈtɛlɪn	hiːz ˈjuːʒəli ˈtɛlɪŋ
ʃi bi ˈtɛlɪn	ʃiːz ˈjuːʒəli ˈtɛlɪŋ
ðeɪ bi ˈtɛlɪn	ðeɪ ˈjuːʒəli ˈtɛlɪŋ
hi bi ˈtwikɪn	hiːz ˈjuːʒəli ˈtwikɪŋ
ʃi bi ˈtwikɪn	ʃiːz ˈjuːʒəli ˈtwikɪŋ
ðeɪ bi ˈtwikɪn	ðeɪ ˈjuːʒəli ˈtwikɪŋ
hi bi ˈɡɪvɪn	hiːz ˈjuːʒəli ˈɡɪvɪŋ
ʃi bi ˈɡɪvɪn	ʃiːz ˈjuːʒəli ˈɡɪvɪŋ
ðeɪ bi ˈɡɪvɪn	ðeɪ ˈjuːʒəli ˈɡɪvɪŋ
hi bi ˈkipɪn	hiːz ˈjuːʒəli ˈkipɪŋ
ʃi bi ˈkipɪn	ʃiːz ˈjuːʒəli ˈkipɪŋ
ðeɪ bi ˈkipɪn	ðeɪ ˈjuːʒəli ˈkipɪŋ
hi bi ˈkɹuzɪn	hiːz ˈjuːʒəli ˈkɹuzɪŋ
ʃi bi ˈkɹuzɪn	ʃiːz ˈjuːʒəli ˈkɹuzɪŋ
ðeɪ bi ˈkɹuzɪn	ðeɪ ˈjuːʒəli ˈkɹuzɪŋ
hi bi ˈsɛndɪn	hiːz ˈjuːʒəli ˈsɛndɪŋ
ʃi bi ˈsɛndɪn	ʃiːz ˈjuːʒəli ˈsɛndɪŋ
ðeɪ bi ˈsɛndɪn	ðeɪ ˈjuːʒəli ˈsɛndɪŋ
hi bi ˈswɪŋɪn	hiːz ˈjuːʒəli ˈswɪŋɪŋ
ʃi bi ˈswɪŋɪn	ʃiːz ˈjuːʒəli ˈswɪŋɪŋ
ðeɪ bi ˈswɪŋɪn	ðeɪ ˈjuːʒəli ˈswɪŋɪŋ
hi bi ˈlɪsənɪn	hiːz ˈjuːʒəli ˈlɪsənɪŋ
ʃi bi ˈlɪsənɪn	ʃiːz ˈjuːʒəli ˈlɪsənɪŋ
ðeɪ bi ˈlɪsənɪn	ðeɪ ˈjuːʒəli ˈlɪsənɪŋ
hi bi ˈlɪvɪn	hiːz ˈjuːʒəli ˈlɪvɪŋ
ʃi bi ˈlɪvɪn	ʃiːz ˈjuːʒəli ˈlɪvɪŋ
ðeɪ bi ˈlɪvɪn	ðeɪ ˈjuːʒəli ˈlɪvɪŋ
hi bi ˈlaɪɪn	hiːz ˈjuːʒəli ˈlaɪɪŋ
ʃi bi ˈlaɪɪn	ʃiːz ˈjuːʒəli ˈlaɪɪŋ
ðeɪ bi ˈlaɪɪn	ðeɪ ˈjuːʒəli ˈlaɪɪŋ
hi bi ˈwɜːkɪn	hiːz ˈjuːʒəli ˈwɜːkɪŋ
ʃi bi ˈwɜːkɪn	ʃiːz ˈjuːʒəli ˈwɜːkɪŋ
ðeɪ bi ˈwɜːkɪn	ðeɪ ˈjuːʒəli ˈwɜːkɪŋ
hi bi ˈwʊfɪn	hiːz ˈjuːʒəli ˈwʊfɪŋ
ʃi bi ˈwʊfɪn	ʃiːz ˈjuːʒəli ˈwʊfɪŋ
ðeɪ bi ˈwʊfɪn	ðeɪ ˈjuːʒəli ˈwʊfɪŋ
hi bi ˈhævɪn	hiːz ˈjuːʒəli ˈhævɪŋ
ʃi bi ˈhævɪn	ʃiːz ˈjuːʒəli ˈhævɪŋ
ðeɪ bi ˈhævɪn	ðeɪ ˈjuːʒəli ˈhævɪŋ
hi bi ˈpɒpɪn	hiːz ˈjuːʒəli ˈpɒpɪŋ
ʃi bi ˈpɒpɪn	ʃiːz ˈjuːʒəli ˈpɒpɪŋ
ðeɪ bi ˈpɒpɪn	ðeɪ ˈjuːʒəli ˈpɒpɪŋ
hi bi ˈʧeɪsɪn	hiːz ˈjuːʒəli ˈʧeɪsɪŋ
ʃi bi ˈʧeɪsɪn	ʃiːz ˈjuːʒəli ˈʧeɪsɪŋ
ðeɪ bi ˈʧeɪsɪn	ðeɪ ˈjuːʒəli ˈʧeɪsɪŋ
hi bi ˈfʌkɪn	hiːz ˈjuːʒəli ˈfʌkɪŋ
ʃi bi ˈfʌkɪn	ʃiːz ˈjuːʒəli ˈfʌkɪŋ
ðeɪ bi ˈfʌkɪn	ðeɪ ˈjuːʒəli ˈfʌkɪŋ
hi bi ˈflaɪɪn	hiːz ˈjuːʒəli ˈflaɪɪŋ
ʃi bi ˈflaɪɪn	ʃiːz ˈjuːʒəli ˈflaɪɪŋ
ðeɪ bi ˈflaɪɪn	ðeɪ ˈjuːʒəli ˈflaɪɪŋ
hi bi ˈbluːmɪn	hiːz ˈjuːʒəli ˈbluːmɪŋ
ʃi bi ˈbluːmɪn	ʃiːz ˈjuːʒəli ˈbluːmɪŋ
ðeɪ bi ˈbluːmɪn	ðeɪ ˈjuːʒəli ˈbluːmɪŋ
hi bi ˈbɒpɪn	hiːz ˈjuːʒəli ˈbɒpɪŋ
ʃi bi ˈbɒpɪn	ʃiːz ˈjuːʒəli ˈbɒpɪŋ
ðeɪ bi ˈbɒpɪn	ðeɪ ˈjuːʒəli ˈbɒpɪŋ
hi bi ˈɹoʊlɪn	hiːz ˈjuːʒəli ˈɹoʊlɪŋ
ʃi bi ˈɹoʊlɪn	ʃiːz ˈjuːʒəli ˈɹoʊlɪŋ
ðeɪ bi ˈɹoʊlɪn	ðeɪ ˈjuːʒəli ˈɹoʊlɪŋ
hi bi ˈtɜːnɪn	hiːz ˈjuːʒəli ˈtɜːnɪŋ
ʃi bi ˈtɜːnɪn	ʃiːz ˈjuːʒəli ˈtɜːnɪŋ
ðeɪ bi ˈtɜːnɪn	ðeɪ ˈjuːʒəli ˈtɜːnɪŋ
hi bi ˈhaʊlɪn	hiːz ˈjuːʒəli ˈhaʊlɪŋ
ʃi bi ˈhaʊlɪn	ʃiːz ˈjuːʒəli ˈhaʊlɪŋ
ðeɪ bi ˈhaʊlɪn	ðeɪ ˈjuːʒəli ˈhaʊlɪŋ
hi bi ˈduːɪn	hiːz ˈjuːʒəli ˈduːɪŋ
ʃi bi ˈduːɪn	ʃiːz ˈjuːʒəli ˈduːɪŋ
ðeɪ bi ˈduːɪn	ðeɪ ˈjuːʒəli ˈduːɪŋ
hi bi ˈɹæŋkɪn	hiːz ˈjuːʒəli ˈɹæŋkɪŋ
ʃi bi ˈɹæŋkɪn	ʃiːz ˈjuːʒəli ˈɹæŋkɪŋ
ðeɪ bi ˈɹæŋkɪn	ðeɪ ˈjuːʒəli ˈɹæŋkɪŋ
hi bi ˈhæpənɪn	hiːz ˈjuːʒuəli ˈhæpənɪŋ
ʃi bi ˈhæpənɪŋ	ʃiːz ˈjuːʒuəli ˈhæpənɪŋ
ðeɪ bi ˈhæpənɪŋ	ðeɪər ˈjuːʒuəli ˈhæpənɪŋ
hi bi ˈɡreɪtɪŋ	hiːz ˈjuːʒuəli ˈɡreɪtɪŋ
ʃi bi ˈɡreɪtɪŋ	ʃiːz ˈjuːʒuəli ˈɡreɪtɪŋ
ðeɪ bi ˈɡreɪtɪŋ	ðeɪər ˈjuːʒuəli ˈɡreɪtɪŋ
hi bi ˈstrɛsɪŋ	hiːz ˈjuːʒuəli ˈstrɛsɪŋ
ʃi bi ˈstrɛsɪŋ	ʃiːz ˈjuːʒuəli ˈstrɛsɪŋ
ðeɪ bi ˈstrɛsɪŋ	ðeɪər ˈjuːʒuəli ˈstrɛsɪŋ
hi bi ˈlɜːrkɪŋ	hiːz ˈjuːʒuəli ˈlɜːrkɪŋ
ʃi bi ˈlɜːrkɪŋ	ʃiːz ˈjuːʒuəli ˈlɜːrkɪŋ
ðeɪ bi ˈlɜːrkɪŋ	ðeɪər ˈjuːʒuəli ˈlɜːrkɪŋ
hi bi ˈsiːɪŋ	hiːz ˈjuːʒuəli ˈsiːɪŋ
ʃi bi ˈsiːɪŋ	ʃiːz ˈjuːʒuəli ˈsiːɪŋ
ðeɪ bi ˈsiːɪŋ	ðeɪər ˈjuːʒuəli ˈsiːɪŋ
hi bi ˈhɪtɪŋ	hiːz ˈjuːʒuəli ˈhɪtɪŋ
ʃi bi ˈhɪtɪŋ	ʃiːz ˈjuːʒuəli ˈhɪtɪŋ
ðeɪ bi ˈhɪtɪŋ	ðeɪər ˈjuːʒuəli ˈhɪtɪŋ
hi bi ˈivnɪŋ	hiːz ˈjuːʒuəli ˈivnɪŋ
ʃi bi ˈivnɪŋ	ʃiːz ˈjuːʒuəli ˈivnɪŋ
ðeɪ bi ˈivnɪŋ	ðeɪər ˈjuːʒuəli ˈivnɪŋ
hi bi ˈdraɪvɪŋ	hiːz ˈjuːʒuəli ˈdraɪvɪŋ
ʃi bi ˈdraɪvɪŋ	ʃiːz ˈjuːʒuəli ˈdraɪvɪŋ
ðeɪ bi ˈdraɪvɪŋ	ðeɪər ˈjuːʒuəli ˈdraɪvɪŋ
hi bi ˈsɜːrfɪŋ	hiːz ˈjuːʒuəli ˈsɜːrfɪŋ
ʃi bi ˈsɜːrfɪŋ	ʃiːz ˈjuːʒuəli ˈsɜːrfɪŋ
ðeɪ bi ˈsɜːrfɪŋ	ðeɪər ˈjuːʒuəli ˈsɜːrfɪŋ
hi bi ˈfriːkɪŋ	hiːz ˈjuːʒuəli ˈfriːkɪŋ
ʃi bi ˈfriːkɪŋ	ʃiːz ˈjuːʒuəli ˈfriːkɪŋ
ðeɪ bi ˈfriːkɪŋ	ðeɪər ˈjuːʒuəli ˈfriːkɪŋ
hi bi ˈʃoʊɪŋ	hiːz ˈjuːʒuəli ˈʃoʊɪŋ
ʃi bi ˈʃoʊɪŋ	ʃiːz ˈjuːʒuəli ˈʃoʊɪŋ
ðeɪ bi ˈʃoʊɪŋ	ðeɪər ˈjuːʒuəli ˈʃoʊɪŋ
hi bi ˈhɪtʃɪŋ	hiːz ˈjuːʒuəli ˈhɪtʃɪŋ
ʃi bi ˈhɪtʃɪŋ	ʃiːz ˈjuːʒuəli ˈhɪtʃɪŋ
ðeɪ bi ˈhɪtʃɪŋ	ðeɪər ˈjuːʒuəli ˈhɪtʃɪŋ
hi bi ˈwɛrɪŋ	hiːz ˈjuːʒuəli ˈwɛrɪŋ
ʃi bi ˈwɛrɪŋ	ʃiːz ˈjuːʒuəli ˈwɛrɪŋ
ðeɪ bi ˈwɛrɪŋ	ðeɪər ˈjuːʒuəli ˈwɛrɪŋ
hi bi ˈtrɪpɪŋ	hiːz ˈjuːʒuəli ˈtrɪpɪŋ
ʃi bi ˈtrɪpɪŋ	ʃiːz ˈjuːʒuəli ˈtrɪpɪŋ
ðeɪ bi ˈtrɪpɪŋ	ðeɪər ˈjuːʒuəli ˈtrɪpɪŋ
hi bi ˈstaɪlɪŋ	hiːz ˈjuːʒuəli ˈstaɪlɪŋ
ʃi bi ˈstaɪlɪŋ	ʃiːz ˈjuːʒuəli ˈstaɪlɪŋ
ðeɪ bi ˈstaɪlɪŋ	ðeɪər ˈjuːʒuəli ˈstaɪlɪŋ
hi bi ˈbiːɪŋ	hiːz ˈjuːʒuəli ˈbiːɪŋ
ʃi bi ˈbiːɪŋ	ʃiːz ˈjuːʒuəli ˈbiːɪŋ
ðeɪ bi ˈbiːɪŋ	ðeɪər ˈjuːʒuəli ˈbiːɪŋ
hi bi ˈblɪŋkɪŋ	hiːz ˈjuːʒuəli ˈblɪŋkɪŋ
ʃi bi ˈblɪŋkɪŋ	ʃiːz ˈjuːʒuəli ˈblɪŋkɪŋ
ðeɪ bi ˈblɪŋkɪŋ	ðeɪər ˈjuːʒuəli ˈblɪŋkɪŋ
hi bi ˈrʌnɪŋ	hiːz ˈjuːʒuəli ˈrʌnɪŋ
ʃi bi ˈrʌnɪŋ	ʃiːz ˈjuːʒuəli ˈrʌnɪŋ
ðeɪ bi ˈrʌnɪŋ	ðeɪər ˈjuːʒuəli ˈrʌnɪŋ
hi bi ˈtʃɪlɪŋ	hiːz ˈjuːʒuəli ˈtʃɪlɪŋ
ʃi bi ˈtʃɪlɪŋ	ʃiːz ˈjuːʒuəli ˈtʃɪlɪŋ
ðeɪ bi ˈtʃɪlɪŋ	ðeɪər ˈjuːʒuəli ˈtʃɪlɪŋ
hi bi ˈɡruːvɪŋ	hiːz ˈjuːʒuəli ˈɡruːvɪŋ
ʃi bi ˈɡruːvɪŋ	ʃiːz ˈjuːʒuəli ˈɡruːvɪŋ
ðeɪ bi ˈɡruːvɪŋ	ðeɪər ˈjuːʒuəli ˈɡruːvɪŋ
hi bi ˈsliːpɪŋ	hiːz ˈjuːʒuəli ˈsliːpɪŋ
ʃi bi ˈsliːpɪŋ	ʃiːz ˈjuːʒuəli ˈsliːpɪŋ
ðeɪ bi ˈsliːpɪŋ	ðeɪər ˈjuːʒuəli ˈsliːpɪŋ
hi bi ˈənɔɪɪŋ	hiːz ˈjuːʒuəli ˈənɔɪɪŋ
ʃi bi ˈənɔɪɪŋ	ʃiːz ˈjuːʒuəli ˈənɔɪɪŋ
ðeɪ bi ˈənɔɪɪŋ	ðeɪər ˈjuːʒuəli ˈənɔɪɪŋ
hi bi ˈstɪŋkɪŋ	hiːz ˈjuːʒuəli ˈstɪŋkɪŋ
ʃi bi ˈstɪŋkɪŋ	ʃiːz ˈjuːʒuəli ˈstɪŋkɪŋ
ðeɪ bi ˈstɪŋkɪŋ	ðeɪər ˈjuːʒuəli ˈstɪŋkɪŋ
hi bi ˈdʌŋkɪŋ	hiːz ˈjuːʒuəli ˈdʌŋkɪŋ
ʃi bi ˈdʌŋkɪŋ	ʃiːz ˈjuːʒuəli ˈdʌŋkɪŋ
ðeɪ bi ˈdʌŋkɪŋ	ðeɪər ˈjuːʒuəli ˈdʌŋkɪŋ
hi bi ˈreɪdʒɪŋ	hiːz ˈjuːʒuəli ˈreɪdʒɪŋ
ʃi bi ˈreɪdʒɪŋ	ʃiːz ˈjuːʒuəli ˈreɪdʒɪŋ
ðeɪ bi ˈreɪdʒɪŋ	ðeɪər ˈjuːʒuəli ˈreɪdʒɪŋ
hi bi ˈhɛdɪŋ	hiːz ˈjuːʒuəli ˈhɛdɪŋ
ʃi bi ˈhɛdɪŋ	ʃiːz ˈjuːʒuəli ˈhɛdɪŋ
ðeɪ bi ˈhɛdɪŋ	ðeɪər ˈjuːʒuəli ˈhɛdɪŋ
hi bi ˈbuːmɪŋ	hiːz ˈjuːʒuəli ˈbuːmɪŋ
ʃi bi ˈbuːmɪŋ	ʃiːz ˈjuːʒuəli ˈbuːmɪŋ
ðeɪ bi ˈbuːmɪŋ	ðeɪər ˈjuːʒuəli ˈbuːmɪŋ
hi bi ˈpʊtɪŋ	hiːz ˈjuːʒuəli ˈpʊtɪŋ
ʃi bi ˈpʊtɪŋ	ʃiːz ˈjuːʒuəli ˈpʊtɪŋ
ðeɪ bi ˈpʊtɪŋ	ðeɪər ˈjuːʒuəli ˈpʊtɪŋ
hi bi ˈtwiːtɪŋ	hiːz ˈjuːʒuəli ˈtwiːtɪŋ
ʃi bi ˈtwiːtɪŋ	ʃiːz ˈjuːʒuəli ˈtwiːtɪŋ
ðeɪ bi ˈtwiːtɪŋ	ðeɪər ˈjuːʒuəli ˈtwiːtɪŋ
